XOSSOXOOOOXOOOOXXX
OOOOOOOOOOOOOOOOOX
OOOOOOOOOOOOOOOOOO
OOOOOOOOOOOOOOOOOO
OOOOOOOOOOOOOOOOOO
OOOOOOOOOOOOOOOOOO
OOOOOOOOOOOOOOOOOO
OOOOOOOOOOOOOOOOOO
OOOOOOOOOOOOOOOOOO
XXOOOOOOOOOOOOOOOO
XXXOOOOOOOOOOOOOOO
